13 31
1 1 1 1 1 1 1 1 1 1 1 1 1 1 1 1 1 1 1 1 1 1 1 1 1 1 1 1 1 1 1
1 4           2 2   2     5   2   6   2     2   2   2       1      
1   1   1   1 2 1   1   1 2 1 2 1   1   1   1 2 1 2 1 2 1   1
1     3 2           2 2 2     2     5       2   6   2   2   1
1   1   1   1   1   1 2 1   1   1 2 1 2 1   1   1   1   1 2 1
1 8                   3   2 2     2     2       5           1
1   1   1   1   1   1   1   1   1   1 2 1   1 2 1   1   1   1
1 2     2             2     2             2                 1
1   1   1   1   1 2 1   1   1   1 2 1 2 1   1   1   1   1   1
1 2         2 2     2               2                       1
1   1 2 1   1   1   1           1 2 1   1   1   1   1   1   1
1                   2           2     2                     1
1 1 1 1 1 1 1 1 1 1 1 1 1 1 1 1 1 1 1 1 1 1 1 1 1 1 1 1 1 1 1
